  		NO           ./ruta/al_archivo
      SO          ./ruta/al_archivo
WE ./ruta/al_archivo
EA ./ruta/al_archivo



F 255,255,255
C 0,0,0



hdfassjkdhdfjs
111111111111111
1000000N00000001
111111111111111
