  		NO           ./textures/file.png
      SO          ./textures/file2.png
WE ./textures/file3.png
EA ./textures/file4.png



F 255, 255,255
C 23,23,232

11111111111111111111
10000000000000000001
11111111111111111111
