F 70, 50,       30 
WE ./textures/West.xpm
  		NO           ./textures/North.xpm    
EA ./textures/East.xpm
O ./textures/Opened.xpm
SO ./textures/South.xpm
D ./textures/Door.xpm


C 50, 45, 40

        11111111111111111111111
        10000000001100000000001
        10110000011100000000001
        10010000002000000000001
1111111110110000010100000000001
1000000000110000011101111121111
11110111111111011100000010001
11112111111111011101010010001 
11000000110101011100000010001
10000000000000001100000010001
10000000000000001101010010001
11000001110101011111011110N0111 
11110111 1110101 101111010001
111111111 1111111 111111 11111
1
1
11
