F 70, 50,       30 
WE ./textures/East.xpm
  		NO           ./textures/East.xpm    
EA ./textures/East.xpm
O ./textures/Opened.xpm
SO ./textures/East.xpm
D ./textures/Door.xpm


C 50, 45, 40

11111111111111111111111111
10000001001000002010000001
11111101011011111110111111
11111101010000201112111111111
11111100010111111110111111
11111110112111111100000001
10000000000000010000000001
11111110111111101111110111111
11111112111111121111112111
10000000000000000000000001    
1000000001000100010001000111
1000E000000000000000000001
11111111111111111111111111111
